# # # # # # # # # #
    #             #
#   #   #   # #   
#   #   # # # #   #
#   #         #   #
#   #   # # # #   #
#   #         #   #
#   # # # #   #   #
#             #    
# # # # # # # # # #