# # # # # # # # # #
    #              
#   #   #   # #   #
#   #   # # # #   #
#   #         #   #
#   #   # # # #   #
#   #             #
#   # # # #   #   #
#             #   #
# # # # # # # # # #