# # # # # # # # # #
. . # . . . . . . #
# . # . # . # # . #
# . # . # # # # . #
# . # . . . . # . #
# . # . # # # # . #
# . # . . . . # . #
# . # # # # . # . #
# . . . . . . # . #
# # # # # # # # # #