# # # # # # # # # #
    #             #
#   #   #   # #   #
#   #   # # # #   #
#   #         #   #
#   #   # # # #   #
#   #             #
#   # # # #   #   #
#             #    
# # # # # # # # # #