# # # # # # # # # #
#   #             #
#   #   #   # #   #
#   #   # # # #   #
#   #         #   #
#   #   # # # #   #
#   #         #   #
#   # # # #   #   #
#             #    
# # # # # # # # # #