##########
  #      #
# # # ## #
# # #### #
# #    # #
# # #### #
# #    # #
# #### # #
#      #    
##########
